12 15
XXXXXXXXXXXXXXX
X|-----------|X
X|-|||||||||-|X
X|-|---#---|-|X
X|-|-|||||-|-|X
X|-|-|-|-|-|-|X
X|-|.|.|.|.|-|X
X|-#-+-+-+-#-|X
X|.|-|||||-|.|X
X|-|---#---|-|X
X|||||||||||||X
XXXXXXXXXXXXXXX
8
H 7 1 S -
H 6 3 S -
B 7 5 N |
B 7 7 S +
A 10 10 S |
X 11 2 S |
C 3 3 S |
T 1 1 S |
